NO ./n.xpm
SO ./s.xpm
WE ./w.xpm
EA ./e.xpm

F 0,0,0
C 255,255,255

1111
1N01
10 1   <-- espacio abierto
1111