NO ./n.xpm
SO ./s.xpm
WE ./w.xpm
EA ./e.xpm

F 0,0,0
C 255,255,255

11111
1N0S1
10001
11111