NO ./n.xpm
SO ./s.xpm
WE ./w.xpm
EA ./e.xpm

F 20,100,180
C 100,200,255

1111111
1 0N  1
1 111 1
1     1
1111111